2,2,2,2,2,2,2,2,2
2,3,3,3,3,3,3,3,2
2,3,4,4,4,4,4,3,2
2,3,1,1,1,1,1,3,2
2,3,4,4,4,4,4,3,2
2,3,3,3,3,3,3,3,2
2,2,2,2,2,2,2,2,2